** Basscoast 2019 Opinionated Cheatsheet by Ryan. Use at your own risk! **
 
There will be surprises and artists I've overlooked or overhyped for sure!
I'm biased towards bass music and complex end of dance music, and usually bored with house
so if you're a big house fan, my star ratings will be less useful to you.
	
 * means I'm pumped on this artist       ** means I'm extremely pumped on this artist	
	
Artist - Locale. (Label optional). Genre/description. (opinionated star rating)
-------------------------------------------------------------------------------
Abstrakt Sonance - BC. Deep dubstep. **
Agrippa - UK. Techno, Bass music, dub, bashment *
AIDA - Vancouver. Tech house
Alix Perez - EU. bass music **
Alter Echo & E3 - Portland. Dub, dubstep. 
Andor - Squamish. house, garage, dubstep, bass. 
Andy Soloman - BC. house etc eclectic 
Andy Warren - Portland. Ambient techno
Astronautica - LA. Electro, pop, chillwave
Barclay Crenshaw - USA. Dirtybird. Bass, grime, halftime, trap, dubstep, d&b etc. **
Barisone - Portland. eclectic electronic
Bassos Rancheros - Vancouver? 
Bell Curve - NYC. Worst Behavior. Footwork, jungle, rap, garage, techno, haltime, grime *
Ben Tactic - Portland. House
Binhex - Vancouver. Ambient
Black Loops - Berlin. House.
Blenda + Cherry OnTop - Vancouver. Chill r&b, hip-hop, disco
Carissa Gem (Sub Chakra) - Calgary. Sub Chakra. Bass, halftime, jungle, rap etc
Claude VonStroke - USA SF etc. Dirtybird. Tech house **
Courtesy - Denmark. Rave techno.
Dalilah - Vancouver. R&b. 
Dane - Edmonton. Classic house, disco, acid
Danny Corn - Portland? Bass. Halftime etc. *
Deft - London. Ambient garage, chill trap, intrumental hip hop *
Denis Sulta - glasgow, disco house
Derrick Vnuk - Vancouver. Techno, electro.
DJ D.Dee - Vancouver. House.
DJ Dine & Dash (Excursions.fm) - Calgary. House.
DJ Heather - Chicago. House
Donna Crooner (Switch DJs) - Vancouver. Rap, beats, r&b, etc.
Drifting.Dubs - BC. aka Jah Raven. Bass dub techno. 
El Papachango - Bay area, Argentina. Global Bass **
Erica Dee - Vancouver. Vocalist.
ESB - Vancouver. Techno, house.
Esette - Calgary. House.
EZ Riser - Mumbai. Haltime, jungle, d&b, footwork. *
Fort Knox Five - funky, breaks, eclectic
Foxy Moron - Whistler. Classic vinyl 7" etc.
Fracture - UK. Exit, Metalheadz. D&B, haltime, footwork, bass rave spectrum. **
Fraser (Refuge DJs) - Edmonton. Techno.
Freele - Calgary. Techno, acid, house.
G Jones - Cali. Bass music wizardry. High-res, high contrast trippy stuff. **
Garneau - Vancouver. House.
Goopsteppa - Vancouver/Montreal. Chill bass music. **
Greazus - BC. Halftime. **
Grossbuster & Strange Thing - Victoria BC. Bass music spectrum.
Gypsy Phantom - Nelson BC. Eclectic, acid, electronic, chill, fun. 
Handsome Tiger - Vancouver. Bass. *
HomeSick - Alberta. Creative bass music *
Hoola - BC. Old school party DJ
Hubbz - Victoria. Funk etc
Huxley Anne - LA. Spacious bass music. *
I M U R - Vancouver. Electronic pop.
Innezz (Babelink DJs) - Vancouver. Acid, Chillwave, rave, techno.
Jack Ryan (Excursions.fm) - Calgary. House, techno, minimal. 
Jake Robertz - Edmonton. Spacious D&B, halftime, garage.
Jared Love - Vancouver. House, techno, minimal.
Joel Armstrong - Vancouver. House, techno, minimal.
Jpod - Kelowna? BC. Hip hop, dancehall, breaks, funk wobbles.
Jubilee - E. USA. Mixpack. House, garage, electro, dancehall, rave *
JUST SHEILA - Squamish. Eclectic.
Kahn - Bristol. Dub, dubstep, grime, dancehall ** 
Kasey Riot - Vancouver/London. House, techno.
Kursk - USA. Innamind. 140, dubstep, D&B **
Lazy Syrup Orchestra - BC. Funky stuff
Lion-S - Nelson BC. Eclectic party rockin dance music.
Lone - Nottingham. UK funky, garage, acid, techno, house, hardcore, old school rave. *
Longwalkshortdock - Vancouver. Doofy gritty emo bass music. Live? 
Lorne B - BC. Funky house, disco, techno.
Madam X - UK. Bass music, techno, riddim, UK funky, garage, grime **
Mandai - Vancouver. Lighta! Dancehall, bass, grime, r&b. *
Marc Rebillet - NYC. Live loops viral internet sensation. Vocal house * 
Mat the Alien - BC. Multi genre, bass music, turntablism. **
Max Ulis - Vancouver. Bass music, garage, dubstep, techno, uk funky *
MC Crystal Precious - Vancouver, vocalist
MC Dizzy D - Microphone hypeman 
Metafloor (Sub Chakra) - AB. Bass music, halftime *
Michael Red - Vancouver. Deep bass music.*
Mike Slott - NYC. Ambient, minimal, pop
Minor Science - UK? Very interesting leftfield electro. *
Mood Change (Excursions.fm) - Calgary. House
Nathan Jonson - Canada. Ambient, electro techno.
Neighbour - Vancouver. House
Nick Wisdom - Vancouver. Funky house
Nightmares on Wax (DJ Set) - Ibiza. Warp. Funky house and stuff
Noah Pred - Berlin. Techno
Oakk - BC/AB? deep Halftime, bass, dubstep, twerk, reggaeton **
Oceantied - Bengaluru, India. Bass, techno, footwork. *
Om Unit - Bristol UK. Dub, techno, bass, riddim, ambient, d&b, deep **
Orson - Berlin. Leftfield complex techno beats, percussion. *
Overland - Vancouver. Acid techno. *
Prsn - Portland. Dancehall, hip hop, bass.
Quiet City DJs - Vancouver. live noodlry
ra / sol - Calgary/Van. House
Ray Black - Vancouver/Whistler. Eclectic electronic music.
Re:Me - Calgary. House.
Righteous Rainbows of Togetherness - Victoria. Live PA techno/rave/house
Roxy Motorola (Switch DJs) - Vancouver. Old school rave, techno, house
Ruairi Lazers - BC. Live PA, drumming. 
Ryan Elliott - Berlin. Techno. 
Ryan Wells - BC. House.
Sabo - LA. Chill global house. 
Sabota - BC. Max Ulis + Robbie Slade. House. *
Sam Binga - Bristol. House, d&b, footwork, dancehall/riddim **
Segue - Vancouver. Ambient dub.
Self Evident - Vancouver. Lighta! Bass music *
Sergio SP - Toronto. House, techno.
SHAHdjs - Vancouver. Bass music spectrum *
Shannon Hart (Excursions.fm) - Calgary. House, techno. *
Shanti Celeste - Bristol. House, acid, techno *
Shiny Things - Vancouver. Bass music spectrum, deep side **
Shortyallday - Local/Germany. Eclectic electronic
Sivz - Vancouver. Tech house. 
SkiiTour - Whistler. House.
Slim Media Player - Vancouver. House. 
Smalltown DJs - Calgary AB. bootlegs, club, bass house, garage, techno *
Stickybuds - Kelowna. Funk, reggae, jungle, d&b, breaks 
Sweet Anomaly - Vancouver. Minimal, ambient, techno. 
Switch DJs - Vancouver. House, breaks, acid. 
Syd Woz (Switch Djs) - Vancouver. House etc.
Syntax (Sub Chakra) - Calgary. Grime, dubstep, 
Taal Mala - Vancouver. Bass, dub, dancehall *
TAF (Refuge) - Edmonton. Techno
Tank Gyal - Vancouver. Dancehall *
That African - Vancouver. Hip hop, reggae, house, world beats, bass. 
The Funk Hunters - funk breaks
The Librarian - BC. Basscoast boss. Eclectic bass. *
The Tailor - Vancouver. Experimental songs.
Tor - Vancouver. Ambient melodic beats. *
Tusk - Vancouver. Lighta! Eclectic hyperpop bass music spectrum. 
Westerley - BC coast. Deep dub, dubstep*
Woodhead - Vancouver. Veteran eclectic party dj *
Xtine (Babelink DJs) - Vancouver. Acid, electro, techno, house. 
Young Dene - 1st nations infused bass music



Shortlist:
	Agrippa 
	Alix Perez
	Abstrakt Sonance
	Barclay Crenshaw 
	Bell Curve 
	Fractur
	G Jones
	Goopsteppa
	Greazus
	Homesick
	Kahn
	(Kursk x )
	Madam
	Mat The Alien
	Oakk
	Om Unit
	Sam Binga
	Shiny Things (thurs)

Rough Plan:
	
Friday:
	Radio Stage 8pm - 4:30am (Self Evident, Prsn, Fracture, Kahn, Deft, Abstrakt Sonance, Danny Corn)
	Main 9-10pm Goopsteppa
	

Saturday:
	2-3pm Cantina. OAKK			
	5:15 - 6:15: Cantina. Kahn (dancehall)
	7:15 - 8:30 Sam Binga 
	2:30-4pm Slay. MTA	
	10:30pm - 3:30am Slay. (Westerly, Huxley Anne, Barclay Crenshaw, Om Unit)
		
Sunday		
	Slay 
		5:40-6:30pm Homesick
	
	Main	
		8:30pm - 3am (Greazus, Madam X, MTA + Librarian, G Jones, Alix Perez)

	Radio
		3:45 - 7am (Kursk, papachango, Tor)			
	
